The apple		Der Apfel
The apples		Die Äpfel
The pear		Die Birne
The pears		Die Birnen
The bread		Das Brot
The breads		Die Brote
The bun			Das Brötchen
The buns		Die Brötchen
The butter		Die Butter
The egg		Das Ei
The eggs		Die Eier
The fish(Sg)		Der Fisch
The fish(Pl)		Die Fische
The meat		Das Fleisch
The cucumber		Die Gurke
The cucumbers		Die Gurken
The chicken		Das Hähnchen
The potato		Die Kartoffel
The potatoes		Die Kartoffeln
The cheese		Der Käse
The milk		Der Milch
The jam			Die Marmelade
The jams		Die Marmeladen
The carrot		Die Möhre
The carrots		Die Möhren
The muesli		Das Müsli
The mueslis		Die Müslis
The pepper		Der Paprika
The peppers		Die Paprikas
The peach		Der Pfirsich
The peaches		Die Pfirsiche
The cream		Die Sahne
The ham		Die Schinken
The tomato		Die Tomate
The tomatoes		Die Tomaten
The wine		Der Wein
The wines		Die Weine
The grape		Die Weintraube
The grapes		Die Weintrauben
The sausage		Die Wurst
The sausages		Die Würste
The zucchini		Die Zucchini
The zucchinis		Die Zucchinis
The onion		Die Zwiebel
The onions		Die Zwiebeln 
